NO    ./texture/grey.xpm
SO    ./texture/redbrick.xpm
WE    ./texture/mossy_w.xpm
EA    ./texture/wood.xpm

F 74,79, 90
C 195, 231, 245
1111111111111111111111111
1000100000110000000000001
1000100001110000000000001
1111000000000000000000001
111111111011000001110000000000001
100000000011000001110111111111111
11110111111111011100000010001
11110111111111011101010010001
11000000110101011100000010001
10000000000000000000000010001
10000000000000001101010000001
1100000111010101111101111N001
11110111 1110101 101111010001
11111111 1111111 111111111111