NO ./textures/north.xpm
SO ./textures/south.xpm      
WE ./textures/west.xpm
EA ./textures/east.xpm

F 220,100,0 
C 225,30,0

11111111
11100001
10000N01
10100001
10000001
11101111
11101111
11101111
11000011
10000001
11100001
11001001
10000101
10100001
11111111